Author	Title	Tags	Directory
Martin L. Shoemaker	Today I Am Paul	Neil Clarke, The Best Science Fiction of the Year (Volume #1), Science Fiction, Short Story, Novelette	science-fiction
Kelly Robson	The Three Resurrections of Jessica Churchill	Science Fiction, Short Story, Novelette	science-fiction
Ian R. MacLeod	The Visitor From Taured	Best Science Fiction of the Year (#2), 2017, Neil Clarke	science-fiction
Isaac Asimov	Nightfall	short story, novelette, science fiction, 1941, Astounding Science Fiction, Campbell, Emerson	science-fiction
Robert Silverberg, Isaac Asimov	Nightfall	1990, novel, science fiction,	science-fiction
Stanisław Lem; Bill Johnston	Solaris	Stanisław Lem, science fiction,	science-fiction

H. G. Wells	The Star	The Big Book of Science Fiction, Jeff Vandermeer, Ann Vandermeer, short story, novelette, science fiction, 1866-1946, English, 1987	science-fiction
Rokheya Shekhawat Hossain	Sultana’s Dream	The Big Book of Science Fiction, Jeff Vandermeer, Ann Vandermeer, short story, novelette, science fiction,	science-fiction
Karl Hans Strobl	The Triumph of Mechanics	The Big Book of Science Fiction, Jeff Vandermeer, Ann Vandermeer, short story, novelette, science fiction,	science-fiction
Paul Scheerbart	The New Overworld	The Big Book of Science Fiction, Jeff Vandermeer, Ann Vandermeer, short story, novelette, science fiction,	science-fiction
Alfred Jarry	Elements of Pataphysics	The Big Book of Science Fiction, Jeff Vandermeer, Ann Vandermeer, short story, novelette, science fiction,	science-fiction
Miguel de Unamuno	Mechanopolis	The Big Book of Science Fiction, Jeff Vandermeer, Ann Vandermeer, short story, novelette, science fiction,	science-fiction
Yefim Zozulya	The Doom of Principal City	The Big Book of Science Fiction, Jeff Vandermeer, Ann Vandermeer, short story, novelette, science fiction,	science-fiction
W. E. B. Du Bois	The Comet	The Big Book of Science Fiction, Jeff Vandermeer, Ann Vandermeer, short story, novelette, science fiction,	science-fiction
Clare Winger Harris	The Fate of the Poseidonia	The Big Book of Science Fiction, Jeff Vandermeer, Ann Vandermeer, short story, novelette, science fiction,	science-fiction
Edmond Hamilton	The Star Stealers	The Big Book of Science Fiction, Jeff Vandermeer, Ann Vandermeer, short story, novelette, science fiction,	science-fiction
Leslie F. Stone	The Conquest of Gola	The Big Book of Science Fiction, Jeff Vandermeer, Ann Vandermeer, short story, novelette, science fiction,	science-fiction
Stanley G. Weinbaum	A Martian Odyssey	The Big Book of Science Fiction, Jeff Vandermeer, Ann Vandermeer, short story, novelette, science fiction,	science-fiction
A. Merritt	The Last Poet and the Robots	The Big Book of Science Fiction, Jeff Vandermeer, Ann Vandermeer, short story, novelette, science fiction,	science-fiction
Paul Ernst	The Microscopic Giants	The Big Book of Science Fiction, Jeff Vandermeer, Ann Vandermeer, short story, novelette, science fiction,	science-fiction
Jorge Luis Borges	Tlön, Uqbar, Orbis Tertius	The Big Book of Science Fiction, Jeff Vandermeer, Ann Vandermeer, short story, novelette, science fiction,	science-fiction
Clifford D. Simak	Desertion	The Big Book of Science Fiction, Jeff Vandermeer, Ann Vandermeer, short story, novelette, science fiction,	science-fiction
Ray Bradbury	September 2005: The Martian	The Big Book of Science Fiction, Jeff Vandermeer, Ann Vandermeer, short story, novelette, science fiction,	science-fiction
Juan José Arreola	Baby HP	The Big Book of Science Fiction, Jeff Vandermeer, Ann Vandermeer, short story, novelette, science fiction,	science-fiction
James Blish	Surface Tension	The Big Book of Science Fiction, Jeff Vandermeer, Ann Vandermeer, short story, novelette, science fiction,	science-fiction
Philip K. Dick	Beyond Lies the Wub	The Big Book of Science Fiction, Jeff Vandermeer, Ann Vandermeer, short story, novelette, science fiction,	science-fiction
Katherine MacLean	The Snowball Effect	The Big Book of Science Fiction, Jeff Vandermeer, Ann Vandermeer, short story, novelette, science fiction,	science-fiction
Margaret St. Clair	Prott	The Big Book of Science Fiction, Jeff Vandermeer, Ann Vandermeer, short story, novelette, science fiction,	science-fiction
William Tenn	The Liberation of Earth	The Big Book of Science Fiction, Jeff Vandermeer, Ann Vandermeer, short story, novelette, science fiction,	science-fiction
Chad Oliver	Let Me Live in a House	The Big Book of Science Fiction, Jeff Vandermeer, Ann Vandermeer, short story, novelette, science fiction,	science-fiction
Arthur C. Clarke	The Star	The Big Book of Science Fiction, Jeff Vandermeer, Ann Vandermeer, short story, novelette, science fiction,	science-fiction
James H. Schmitz	Grandpa	The Big Book of Science Fiction, Jeff Vandermeer, Ann Vandermeer, short story, novelette, science fiction,	science-fiction
Cordwainer Smith	The Game of Rat and Dragon	The Big Book of Science Fiction, Jeff Vandermeer, Ann Vandermeer, short story, novelette, science fiction,	science-fiction
Isaac Asimov	The Last Question	The Big Book of Science Fiction, Jeff Vandermeer, Ann Vandermeer, short story, novelette, science fiction,	science-fiction
Damon Knight	Stranger Station	The Big Book of Science Fiction, Jeff Vandermeer, Ann Vandermeer, short story, novelette, science fiction,	science-fiction
James White	Sector General	The Big Book of Science Fiction, Jeff Vandermeer, Ann Vandermeer, short story, novelette, science fiction,	science-fiction
Arkady and Boris Strugatsky	The Visitors	The Big Book of Science Fiction, Jeff Vandermeer, Ann Vandermeer, short story, novelette, science fiction,	science-fiction
Carol Emshwiller	Pelt	The Big Book of Science Fiction, Jeff Vandermeer, Ann Vandermeer, short story, novelette, science fiction,	science-fiction
Gérard Klein	The Monster	The Big Book of Science Fiction, Jeff Vandermeer, Ann Vandermeer, short story, novelette, science fiction,	science-fiction
Theodore Sturgeon	The Man Who Lost the Sea	The Big Book of Science Fiction, Jeff Vandermeer, Ann Vandermeer, short story, novelette, science fiction,	science-fiction
Silvina Ocampo	The Waves	The Big Book of Science Fiction, Jeff Vandermeer, Ann Vandermeer, short story, novelette, science fiction,	science-fiction
Will Worthington	Plenitude	The Big Book of Science Fiction, Jeff Vandermeer, Ann Vandermeer, short story, novelette, science fiction,	science-fiction
J. G. Ballard	The Voices of Time	The Big Book of Science Fiction, Jeff Vandermeer, Ann Vandermeer, short story, novelette, science fiction,	science-fiction
Adolfo Bioy Casares	The Squid Chooses Its Own Ink	The Big Book of Science Fiction, Jeff Vandermeer, Ann Vandermeer, short story, novelette, science fiction,	science-fiction
Kurt Vonnegut Jr.	2 B R 0 2 B	The Big Book of Science Fiction, Jeff Vandermeer, Ann Vandermeer, short story, novelette, science fiction,	science-fiction
Vadim Shefner	A Modest Genius	The Big Book of Science Fiction, Jeff Vandermeer, Ann Vandermeer, short story, novelette, science fiction,	science-fiction
Sever Gansovsky	Day of Wrath	The Big Book of Science Fiction, Jeff Vandermeer, Ann Vandermeer, short story, novelette, science fiction,	science-fiction
John Baxter	The Hands	The Big Book of Science Fiction, Jeff Vandermeer, Ann Vandermeer, short story, novelette, science fiction,	science-fiction
André Carneiro	Darkness	The Big Book of Science Fiction, Jeff Vandermeer, Ann Vandermeer, short story, novelette, science fiction,	science-fiction
Harlan Ellison	“Repent, Harlequin!” Said the Ticktockman	The Big Book of Science Fiction, Jeff Vandermeer, Ann Vandermeer, short story, novelette, science fiction,	science-fiction
R. A. Lafferty	Nine Hundred Grandmothers	The Big Book of Science Fiction, Jeff Vandermeer, Ann Vandermeer, short story, novelette, science fiction,	science-fiction
Frederik Pohl	Day Million	The Big Book of Science Fiction, Jeff Vandermeer, Ann Vandermeer, short story, novelette, science fiction,	science-fiction
F. L. Wallace	Student Body	The Big Book of Science Fiction, Jeff Vandermeer, Ann Vandermeer, short story, novelette, science fiction,	science-fiction
Samuel R. Delany	Aye, and Gomorrah	The Big Book of Science Fiction, Jeff Vandermeer, Ann Vandermeer, short story, novelette, science fiction,	science-fiction
Langdon Jones	The Hall of Machines	The Big Book of Science Fiction, Jeff Vandermeer, Ann Vandermeer, short story, novelette, science fiction,	science-fiction
Yoshio Aramaki	Soft Clocks	The Big Book of Science Fiction, Jeff Vandermeer, Ann Vandermeer, short story, novelette, science fiction,	science-fiction
David R. Bunch	Three from Moderan	The Big Book of Science Fiction, Jeff Vandermeer, Ann Vandermeer, short story, novelette, science fiction,	science-fiction
Stanisław Lem	Let Us Save the Universe	The Big Book of Science Fiction, Jeff Vandermeer, Ann Vandermeer, short story, novelette, science fiction,	science-fiction
Ursula K. Le Guin	Vaster Than Empires and More Slow	The Big Book of Science Fiction, Jeff Vandermeer, Ann Vandermeer, short story, novelette, science fiction,	science-fiction
Robert Silverberg	Good News from the Vatican	The Big Book of Science Fiction, Jeff Vandermeer, Ann Vandermeer, short story, novelette, science fiction,	science-fiction
Joanna Russ	When It Changed	The Big Book of Science Fiction, Jeff Vandermeer, Ann Vandermeer, short story, novelette, science fiction,	science-fiction
James Tiptree Jr.	And I Awoke and Found Me Here on the Cold Hill’s Side	The Big Book of Science Fiction, Jeff Vandermeer, Ann Vandermeer, short story, novelette, science fiction,	science-fiction
Dmitri Bilenkin	Where Two Paths Cross	The Big Book of Science Fiction, Jeff Vandermeer, Ann Vandermeer, short story, novelette, science fiction,	science-fiction
Yasutaka Tsutsui	Standing Woman	The Big Book of Science Fiction, Jeff Vandermeer, Ann Vandermeer, short story, novelette, science fiction,	science-fiction
Alicia Yánez Cossío	The IWM 1000	The Big Book of Science Fiction, Jeff Vandermeer, Ann Vandermeer, short story, novelette, science fiction,	science-fiction
Michael Bishop	The House of Compassionate Sharers	The Big Book of Science Fiction, Jeff Vandermeer, Ann Vandermeer, short story, novelette, science fiction,	science-fiction
Barrington J. Bayley	Sporting with the Chid	The Big Book of Science Fiction, Jeff Vandermeer, Ann Vandermeer, short story, novelette, science fiction,	science-fiction
George R. R. Martin	Sandkings	The Big Book of Science Fiction, Jeff Vandermeer, Ann Vandermeer, short story, novelette, science fiction,	science-fiction
Lisa Tuttle	Wives	The Big Book of Science Fiction, Jeff Vandermeer, Ann Vandermeer, short story, novelette, science fiction,	science-fiction
Josephine Saxton	The Snake Who Had Read Chomsky	The Big Book of Science Fiction, Jeff Vandermeer, Ann Vandermeer, short story, novelette, science fiction,	science-fiction
Kajio Shinji	Reiko’s Universe Box	The Big Book of Science Fiction, Jeff Vandermeer, Ann Vandermeer, short story, novelette, science fiction,	science-fiction
Bruce Sterling	Swarm	The Big Book of Science Fiction, Jeff Vandermeer, Ann Vandermeer, short story, novelette, science fiction,	science-fiction
Jacques Barbéri	Mondocane	The Big Book of Science Fiction, Jeff Vandermeer, Ann Vandermeer, short story, novelette, science fiction,	science-fiction
Greg Bear	Blood Music	The Big Book of Science Fiction, Jeff Vandermeer, Ann Vandermeer, short story, novelette, science fiction,	science-fiction
Octavia E. Butler	Bloodchild	The Big Book of Science Fiction, Jeff Vandermeer, Ann Vandermeer, short story, novelette, science fiction,	science-fiction
Pat Cadigan	Variation on a Man	The Big Book of Science Fiction, Jeff Vandermeer, Ann Vandermeer, short story, novelette, science fiction,	science-fiction
S. N. Dyer	Passing as a Flower in the City of the Dead	The Big Book of Science Fiction, Jeff Vandermeer, Ann Vandermeer, short story, novelette, science fiction,	science-fiction
William Gibson	New Rose Hotel	The Big Book of Science Fiction, Jeff Vandermeer, Ann Vandermeer, short story, novelette, science fiction,	science-fiction
C. J. Cherryh	Pots	The Big Book of Science Fiction, Jeff Vandermeer, Ann Vandermeer, short story, novelette, science fiction,	science-fiction
John Crowley	Snow	The Big Book of Science Fiction, Jeff Vandermeer, Ann Vandermeer, short story, novelette, science fiction,	science-fiction
Karen Joy Fowler	The Lake Was Full of Artificial Things	The Big Book of Science Fiction, Jeff Vandermeer, Ann Vandermeer, short story, novelette, science fiction,	science-fiction
Angélica Gorodischer	The Unmistakable Smell of Wood Violets	The Big Book of Science Fiction, Jeff Vandermeer, Ann Vandermeer, short story, novelette, science fiction,	science-fiction
Jon Bing	The Owl of Bear Island	The Big Book of Science Fiction, Jeff Vandermeer, Ann Vandermeer, short story, novelette, science fiction,	science-fiction
Élisabeth Vonarburg	Readers of the Lost Art	The Big Book of Science Fiction, Jeff Vandermeer, Ann Vandermeer, short story, novelette, science fiction,	science-fiction
Iain M. Banks	A Gift from the Culture	The Big Book of Science Fiction, Jeff Vandermeer, Ann Vandermeer, short story, novelette, science fiction,	science-fiction
Jean-Claude Dunyach	Paranamanco	The Big Book of Science Fiction, Jeff Vandermeer, Ann Vandermeer, short story, novelette, science fiction,	science-fiction
Tanith Lee	Crying in the Rain	The Big Book of Science Fiction, Jeff Vandermeer, Ann Vandermeer, short story, novelette, science fiction,	science-fiction
Michael Moorcock	The Frozen Cardinal	The Big Book of Science Fiction, Jeff Vandermeer, Ann Vandermeer, short story, novelette, science fiction,	science-fiction
Pat Murphy	Rachel in Love	The Big Book of Science Fiction, Jeff Vandermeer, Ann Vandermeer, short story, novelette, science fiction,	science-fiction
Manjula Padmanabhan	Sharing Air	The Big Book of Science Fiction, Jeff Vandermeer, Ann Vandermeer, short story, novelette, science fiction,	science-fiction
Connie Willis	Schwarzschild Radius	The Big Book of Science Fiction, Jeff Vandermeer, Ann Vandermeer, short story, novelette, science fiction,	science-fiction
Gene Wolfe	All the Hues of Hell	The Big Book of Science Fiction, Jeff Vandermeer, Ann Vandermeer, short story, novelette, science fiction,	science-fiction
Geoffrey A. Landis	Vacuum States	The Big Book of Science Fiction, Jeff Vandermeer, Ann Vandermeer, short story, novelette, science fiction,	science-fiction
Han Song	Two Small Birds	The Big Book of Science Fiction, Jeff Vandermeer, Ann Vandermeer, short story, novelette, science fiction,	science-fiction
Rachel Pollack	Burning Sky	The Big Book of Science Fiction, Jeff Vandermeer, Ann Vandermeer, short story, novelette, science fiction,	science-fiction
Kim Stanley Robinson	Before I Wake	The Big Book of Science Fiction, Jeff Vandermeer, Ann Vandermeer, short story, novelette, science fiction,	science-fiction
Misha Nogha	Death Is Static Death Is Movement	The Big Book of Science Fiction, Jeff Vandermeer, Ann Vandermeer, short story, novelette, science fiction,	science-fiction
Michael Blumlein	The Brains of Rats	The Big Book of Science Fiction, Jeff Vandermeer, Ann Vandermeer, short story, novelette, science fiction,	science-fiction
Leena Krohn	Gorgonoids	The Big Book of Science Fiction, Jeff Vandermeer, Ann Vandermeer, short story, novelette, science fiction,	science-fiction
Kojo Laing	Vacancy for the Post of Jesus Christ	The Big Book of Science Fiction, Jeff Vandermeer, Ann Vandermeer, short story, novelette, science fiction,	science-fiction
Gwyneth Jones	The Universe of Things	The Big Book of Science Fiction, Jeff Vandermeer, Ann Vandermeer, short story, novelette, science fiction,	science-fiction
Robert Reed	The Remoras	The Big Book of Science Fiction, Jeff Vandermeer, Ann Vandermeer, short story, novelette, science fiction,	science-fiction
William Tenn	The Ghost Standard	The Big Book of Science Fiction, Jeff Vandermeer, Ann Vandermeer, short story, novelette, science fiction,	science-fiction
Geoffrey Maloney	Remnants of the Virago Crypto-System	The Big Book of Science Fiction, Jeff Vandermeer, Ann Vandermeer, short story, novelette, science fiction,	science-fiction
Stepan Chapman	How Alex Became a Machine	The Big Book of Science Fiction, Jeff Vandermeer, Ann Vandermeer, short story, novelette, science fiction,	science-fiction
Cixin Liu	The Poetry Cloud	The Big Book of Science Fiction, Jeff Vandermeer, Ann Vandermeer, short story, novelette, science fiction,	science-fiction
Ted Chiang	Story of Your Life	The Big Book of Science Fiction, Jeff Vandermeer, Ann Vandermeer, short story, novelette, science fiction,	science-fiction
Cory Doctorow	Craphound	The Big Book of Science Fiction, Jeff Vandermeer, Ann Vandermeer, short story, novelette, science fiction,	science-fiction
Tatyana Tolstaya	The Slynx	The Big Book of Science Fiction, Jeff Vandermeer, Ann Vandermeer, short story, novelette, science fiction,	science-fiction
Johanna Sinisalo	Baby Doll	The Big Book of Science Fiction, Jeff Vandermeer, Ann Vandermeer, short story, novelette, science fiction,	science-fiction
Herbert George Walls	The Star	The Big Book of Science Fiction, Science Fiction, Short Story, Novelette	science-fiction


Vernor Vinge	True Names	Vernor Vinge, 
Stanisław Lem	Hospital of the Transfiguration	Stanisław Lem, science fiction,	science-fiction
Vernor Vinge	A Deepness in the Sky (Zones of Thought, #2)	Vernor Vinge, 
Dan Simmons	Hyperion (Hyperion Cantos, #1)	Dan Simmons, 
H.G. Wells	The Time Machine	H.G. Wells, 1985
Orson Scott Card	Speaker for the Dead (Ender's Saga, #2)	Orson Scott Card, 
Isaac Asimov	Foundation's Edge (Foundation, #4)	Isaac Asimov, 
Robert L. Forward	Dragon's Egg	Robert L. 
Stanisław Lem	Eden	Stanisław Lem, science fiction,	science-fiction
Edwin Abbott	Flatland
Ursula K. Le Guin	The Dispossessed: An Ambiguous Utopia	Ursula K. Le Guin, 
James S.A. Corey	Leviathan Wakes (The Expanse, #1)	James S.A. Corey, 
Isaac Asimov	The End of Eternity	Isaac Asimov, 
Arthur C. Clarke	Childhood’s End	Arthur C. Clarke, 
H.G. Wells	The War of the Worlds	H.G. Wells, 1898
Jules Verne	The Mysterious Island	
Neal Stephenson	Snow Crash	Neal Stephenson, 
Arthur C. Clarke	2001: A Space Odyssey (Space Odyssey, #1)	Arthur C. Clarke, science fiction,	science-fiction
Liu Cixin	The Three-Body Problem (Remembrance of Earth’s Past, #1)	Liu Cixin, 
Michael Chabon	The Yiddish Policemen's Union	Michael Chabon, 
Ray Bradbury	The Chronicles of Mars
Stanisław Lem	The Investigation	Stanisław Lem, science fiction,	science-fiction
Stanisław Lem	Imaginary Magnitude	Stanisław Lem, science fiction,	science-fiction
Isaac Asimov	The Gods Themselves	Isaac Asimov, 
Stanisław Lem	The chain of chance	Stanisław Lem, science fiction,	science-fiction
Vernor Vinge	Rainbows End	Vernor Vinge, 
Stanisław Lem	Peace on Earth	Stanisław Lem, science fiction,	science-fiction
George Orwell	1984	George Orwell, 
Stanisław Lem	Fiasco	Stanisław Lem, science fiction,	science-fiction
Ray Bradbury	Fahrenheit 451	Ray Bradbury, science fiction,	science-fiction
Stanisław Lem	The futrological Congress	Stanisław Lem, science fiction,	science-fiction
Frank Schätzing	The Swarm	Frank Schätzing, science fiction	science-fiction
Isaac Asimov	Foundation and Empire (Foundation, #2)	Isaac Asimov, 
Orson Scott Card	Ender's Shadow (The Shadow Series, #1)	Orson Scott Card, 
Jules Verne	Twenty Thousand Leagues Under the Sea (Captain Nemo, #2)	Jules Verne, 
Philip K. Dick	Valis	Philip K. Dick, 
Stanisław Lem	Memoirs Found in a Bathtube	Stanisław Lem, science fiction,	science-fiction
Isaac Asimov	The Mule: From Foundation And Empire	Isaac Asimov, 
Paolo Bacigalupi	The Windup Girl	Paolo Bacigalupi, 
Stanisław Lem	Highcasle: A remembrance	Stanisław Lem, science fiction,	science-fiction
Stanisław Lem	Tales of Pirx the Pilot	Stanisław Lem, science fiction,	science-fiction
Philip K. Dick	Do Androids Dream of Electric Sheep?	Philip K. Dick, 
Dan Simmons	The Fall of Hyperion (Hyperion Cantos, #2)	Dan Simmons, 
Arthur C. Clarke	The Fountains of Paradise	Arthur C. Clarke, 
Stanisław Lem	The Invisible	Stanisław Lem, science fiction,	science-fiction
Vernor Vinge	A Fire Upon the Deep (Zones of Thought, #1)	Vernor Vinge, 
Jeff Vandermeer	Annihilation
Arkady Martine	A Memory Called Empire (Teixcalaan, #1)	Arkady Martine, 
Walter M. Miller Jr.	A Canticle for Leibowitz (St. Leibowitz, #1)	Walter M. Miller Jr., 
Ray Bradbury	Zen in the art of writing	Ray Bradbury, science fiction,	Frost and Fire	science-fiction
Arkady Strugatsky	Roadside Picnic	Arkady Strugatsky, 
Stanisław Lem	Return from the stars	Stanisław Lem, science fiction,	science-fiction
Stanisław Lem	The Star Diaries	Stanisław Lem, science fiction,	science-fiction
Isaac Asimov	Second Foundation (Foundation, #3)	Isaac Asimov, 
Stanisław Lem	The Truth and Other Stories	Stanisław Lem, science fiction,	science-fiction
Stanisław Lem	His Masters Voice	Stanisław Lem, science fiction,	science-fiction
Andy Weir	Atermis	Andy Weir, 
Isaac Asimov	The Foundation Trilogy (Foundation, #1-3)	Isaac Asimov, 
Stanisław Lem	Microworlds	Stanisław Lem, science fiction,	science-fiction
Stanisław Lem	Place on Earth	Stanisław Lem, science fiction,	science-fiction
Stanisław Lem	Mortal Engines	Stanisław Lem, science fiction,	science-fiction
Aldous Huxley	Brave New World	Aldous Huxley, 
William Gibson	Neuromancer (Sprawl, #1)	William Gibson, 
Robert Silverberg	Thorn
Andy Weir	The Martian	Andy Weir, 
Hannu Rajaniemi	The Casual Angel
Dan Simmons	Hyperion	Science Fiction, Hugo Award, Dan Simmons	science-fiction
Andy Weir	Project Hail Mary	Andy Weir, 
Philip K. Dick	The Minority Report	Philip K. Dick, 
Stanisław Lem	Memoirs of a Space Traveler	Stanisław Lem, science fiction,	science-fiction
Stanisław Lem	One Human Minute	Stanisław Lem, science fiction,	science-fiction
Peter Watts	Blindsight	Peter Watts, science fiction	science-fiction
Stanisław Lem	A perfect Vacuum	Stanisław Lem, science fiction,	science-fiction
Neal Stephenson	Cryptonomicon	Neal Stephenson, 
Stanisław Lem	The Cyberiad	Stanisław Lem, science fiction,	science-fiction
Isaac Asimov	Foundation (Foundation, #1)	Isaac Asimov, 

Thomas Mann	Buddenbrooks: The Decline of a Family	Thomas Mann, 
Robert Shekley	Dramocles
Gregory Benford	darker than darkness
Michael Shea 	Niff the lean
Alasdair Gray 	Lanark	
John Varley	press enter
Kurt Vonnegut Jr.	Galapagos
Russel Griffin	century's end
Dan Brown	Digital Fortress	Dan Brown, 
Doris Lessing	Briefing for a descent into hell
Kazuo Ishiguro	The Remains of the Day	Kazuo Ishiguro, 
Philip José Farmer	World of Tiers
Fyodor Dostoevsky	The Brothers Karamazov	Fyodor Dostoevsky, 
Suzanne Collins	The Hunger Games (The Hunger Games, #1)	Suzanne Collins, 
Victor Hugo	Les Misérables	Victor Hugo, 
Mario Vargas Llosa	Conversation in the Cathedral	Mario Vargas Llosa, 
Pamela Zoline	The Heat Death of the Universe
Charlie Donlea	Twenty Years Later	Charlie Donlea, 
Gregory Benford	Stars in shroud
Christopher Priest	Fugue for a darkening Island
Mario Puzo	The Godfather (The Godfather, #1)	Mario Puzo, 
Hermann Hesse	Steppenwolf	Hermann Hesse, 
Keith Roberts	The chalk giant
J. G. Ballard	concrete island
Michael Crichton	The Andromeda Strain (Andromeda, #1)	Michael Crichton, 
Gabriel García Márquez	Love in the Time of Cholera	Gabriel García Márquez, 
W.B. Yeats	The Collected Poems of W.B. Yeats	W.B. Yeats, 
Frederik Pohl	Gateway (Heechee Saga, #1)	Frederik Pohl, 
Charlaine Harris	Dead Until Dark (Sookie Stackhouse, #1)	Charlaine Harris, 
Daniel Keyes	Flowers for Algernon	Daniel Keyes, 
Carl Sargan	contact
Lois McMaster Bujold	The Vor Game (Vorkosigan Saga, #6)	Lois McMaster Bujold, 
John Kennedy Toole	A Confederacy of Dunces	John Kennedy Toole, 
Robert Ludlum	The Bourne Identity (Jason Bourne, #1)	Robert Ludlum, 
Lucius Shepherd	Green Eyes
William Faulkner	Absalom, Absalom!	William Faulkner, 
Poul Pournelle, Larry Niven	Lucifer's Hammer
Kurt Vonnegut Jr.	God Bless You, Mr. Rosewater
John Brunner	Stand on Zanzibar	John Brunner, 
Ursula K. Le Guin	City of Illusions
Bob Shaw	The two-timers
H.G. Wells	The History of Mr Polly	H.G. Wells, 
John Scalzi	Old Man's War (Old Man's War, #1)	John Scalzi, 
Franz Kafka	The Trial	Franz Kafka, 
Michael Connelly	The Black Echo (Harry Bosch, #1; Harry Bosch Universe, #1)	Michael Connelly, 
Chuck Palahniuk	Not Forever, But For Now	Chuck Palahniuk, 
Laurie R. King	The Beekeeper's Apprentice (Mary Russell and Sherlock Holmes, #1)	Laurie R. King, 
Martha Wells	Network Effect (The Murderbot Diaries, #5)	Martha Wells, 
Marcel Proust	Du côté de chez Swann (À la recherche du temps perdu, #1)	Marcel Proust, 
Jules Verne	Journey to the Center of the Earth	Jules Verne, 
Donald Kinsbury	Geta
Forward, science fiction	science-fiction
T.S. Eliot	The Waste Land	T.S. Eliot, 
Hermann Hesse	Demian	Hermann Hesse, 
Selma Lagerlöf	The Wonderful Adventures of Nils	Selma Lagerlöf, 
Doris Lessing	The Golden Notebook	Doris Lessing, 
Robert Shekley	Immortality Inc.
Emily Tesh	Some Desperate Glory	Emily Tesh, 
Ed Bryant	Wyoming sun
Andrew Van Wey	Head Like a Hole	Andrew Van Wey, 
Erik Larson	The Devil in the White City: Murder, Magic, and Madness at the Fair That Changed America	Erik Larson, 
Yasunari Kawabata	Snow Country	Yasunari Kawabata, 
Anne McCaffrey	Weyr Search
Beam Piper	Omnilingual
Octavia E. Butler	wild seed
N.K. Jemisin	The Stone Sky (The Broken Earth, #3)	N.K. Jemisin, 
Margaret Atwood	The Handmaid’s Tale (The Handmaid's Tale, #1)	Margaret Atwood, 
Suzanne Collins	Catching Fire (The Hunger Games, #2)	Suzanne Collins, 
Russel Griffin	The makeshift god
Michal Kube-MacDowell	Emprise
Albert Camus	The Fall	Albert Camus, 
Paul Anderson	No Truce with Kings
John Grisham	A Time to Kill (Jake Brigance, #1)	John Grisham, 
André Gide	The Immoralist	André Gide, 
Philip K. Dick	The Divine Invasion	Philip K. Dick, 
Anne McCaffrey	Dragonrider
Karin Slaughter	Pretty Girls	Karin Slaughter, 
Cormac McCarthy	No Country for Old Men	Cormac McCarthy, 
Robert Silverberg	Up the line
Iain Banks	The Wasp Factory	Iain Banks, 
Stieg Larsson	The Girl Who Played with Fire (Millennium, #2)	Stieg Larsson, 
Lee Harding	Displaced person
William Makepeace Thackeray	Vanity Fair	William Makepeace Thackeray, 
Clifford D. Simak	grotto of dancing deer
William John Watkins	The centrifugal rickshaw dancer 
Robert Silverberg	shadrach in the furnace
David Brin	The Uplift War (The Uplift Saga, #3)	David Brin, 
Richard Cowper	Clone
Langdon Jones	Eye of the lens 
Barrington Bayley	an overload
Donna Tartt	The Secret History	Donna Tartt, 
Stephen King	Firestarter	Stephen King, 
John Crowley	Little, Big
John Crowley	Little, Big
Poul Pournelle	Mercenery
Dan Brown	Angels & Demons (Robert Langdon, #1)	Dan Brown, 
Alexander McCall Smith	The No. 1 Ladies' Detective Agency (No. 1 Ladies' Detective Agency, #1)	Alexander McCall Smith, 
Gene Wolfe	The fifth head of cerberus
Lois Lowry	The Giver (The Giver, #1)	Lois Lowry, 
Dean Koontz	Intensity	Dean Koontz, 
John Sandford	Rules of Prey (Lucas Davenport, #1)	John Sandford, 
Lee Harding	Waiting for the end of the world
James Morrow	the continent of lies
H.G. Wells	When the sleeper waks	H.G. Wells, 
Robert A. Heinlein	The Moon Is a Harsh Mistress	Robert A. Heinlein, 
Isaac Asimov	The Caves of Steel (Robot, #1)	Isaac Asimov, 
Ray Bradbury	from the dust returned	Ray Bradbury, science fiction,	science-fiction
Robert A. Heinlein	Beyond This Horizon	Robert A. Heinlein, 
Markus Zusak	The Book Thief	Markus Zusak, 
Lucius Shepherd	A spanish lesson
Christopher Paolini	Eragon (The Inheritance Cycle, #1)	Christopher Paolini, 
David Baldacci	Absolute Power	David Baldacci, 
Susan Rowland	Murder on Family Grounds (Mary Wandwalker #3)	Susan Rowland, 
Tomas M. Disch	Echo Round his bones
Joan D. Vinge	The Snow Queen (The Snow Queen Cycle, #1)	Joan D. Vinge, 
Thomas Harris	Red Dragon (Hannibal Lecter, #1)	Thomas Harris, 
Carolyn Keene	The Secret of the Old Clock (Nancy Drew Mystery Stories, #1)	Carolyn Keene, 
William Gibson	The difference Engine	William Gibson, 
China Miéville	The City & the City	China Miéville, 
Ray Bradbury	S is for space	Ray Bradbury, science fiction,	science-fiction
Josef Nesvadba	doctor moreau's other island
Bob Shaw	a wreath of stars
Poul Pournelle	Escape from the planet of the apes
Gregory Benford	Timespace
Robert Silverberg	Time of Change
Mary Kubica	Local Woman Missing	Mary Kubica, 
Orhan Pamuk	Snow	Orhan Pamuk, 
Liane Moriarty	Big Little Lies	Liane Moriarty, 
Bob Shaw	The ragged astronauts
William Faulkner	Light in August	William Faulkner, 
Roger Zelazny	This Immortal	Roger Zelazny, 
Jonna Russ	When it changed 
Doris Lessing	Shikasta
Robert Shekley	Dimension of Miracles
Arcady and Boris Strugatsky	the final circle of paradise
Robert Silverberg	born with the dead
James Joyce	A Portrait of the Artist as a Young Man	James Joyce, 
Arthur C. Clarke	Imperial Earth
Ian Waston	The Embedding
Albert Camus	The Stranger	Albert Camus, 
J. G. Ballard	empire of the sun
Richard Cowper	Breakthrough
Michael Crichton	Jurassic Park (Jurassic Park, #1)	Michael Crichton, 
J. G. Ballard	The Naked Lunch
Jo Walton	Among Others	Jo Walton, 
L. Ron Hubbard	Battlefield Earth
Keith Roberts	kiteworld
Robert L. Forward	Martian Rainbow (1991)
Octavia E. Butler	Parable of the Sower (Earthseed, #1)	Octavia E. Butler, 
Arthur Conan Doyle	The Hound of the Baskervilles (Sherlock Holmes, #5)	Arthur Conan Doyle, 
Lee Child	Killing Floor (Jack Reacher #1)	Lee Child, 
Albert Camus	The Myth of Sisyphus	Albert Camus, 
Douglas Adams	The Restaurant at the End of the Universe (The Hitchhiker's Guide to the Galaxy, #2)	Douglas Adams, 
Ian Waston	The jonah kit
Misba	The Oldest Dance (Wisdom Revolution, #2)	Misba, 
Robert A. Heinlein	Starship Troopers	Robert A. Heinlein, 
Tom Clancy	Clear and Present Danger (Jack Ryan, #5; Jack Ryan Universe, #6)	Tom Clancy, 
Robert L. Forward	Saturn Rukh (1997)
Clifford D. Simak	why call them back from heaven
Keith Roberts	Pavane
Bret Easton Ellis	The Shards	Bret Easton Ellis, 
John Le Carré	The Spy Who Came In from the Cold (George Smiley, #3)	John Le Carré, 
Kiersten Modglin	The Roommate	Kiersten Modglin, 
Beam Piper	Little Fuzzy
Tomas M. Disch	The Squirrel Cage
Ray Bradbury	the golden apples of the sun	Ray Bradbury, science fiction,	science-fiction
Robert Silverberg	Downward to the Earth
Charles Dickens	Great Expectations	Charles Dickens, 
Lee Harding	beyond tomorrow
Jorge Luis Borges	fictions
William Gibson	Mona Lisa Overdrive	William Gibson, 
Marion Zimmer Bradley	The Mists of Avalon (Avalon, #1)	Marion Zimmer Bradley, 
Connie Willis	Blackout (All Clear, #1)	Connie Willis, 
Ira Levin	Rosemary’s Baby (Rosemary's Baby, #1)	Ira Levin, 
Sue Grafton	A Is for Alibi (Kinsey Millhone #1)	Sue Grafton, 
S.J. Watson	Before I Go to Sleep	S.J. Watson, 
Samuel R. Delany	The Jewls of Aptor	1962
Martin Cruz Smith	Gorky Park (Arkady Renko, #1)	Martin Cruz Smith, 
Michael Chabon	The Amazing Adventures of Kavalier & Clay
William Gibson	Virtual Light	William Gibson, 
Frederik Pohl	Beyond the blue event horizon
James Tiptree Jr.	Love is the plan, the plan is death
John Le Carré	Tinker, Tailor, Soldier, Spy (George Smiley, #5; Karla Trilogy, #1)	John Le Carré, 
Mario Vargas Llosa	La ciudad y los perros	Mario Vargas Llosa, 
Madeleine L'Engle	A Wrinkle in Time (Time Quintet, #1)	Madeleine L'Engle, 
Dashiell Hammett	The Maltese Falcon	Dashiell Hammett, 
John Harrison	a storm of wings
Scott Turow	Presumed Innocent (Kindle County Legal Thriller, #1)	Scott Turow, 
George Zebrowsky	Omiga Point
Frederik Pohl	Man plus
Toni Morrison	The Bluest Eye	Toni Morrison, 
Elizabeth George	A Great Deliverance (Inspector Lynley, #1)	Elizabeth George, 
Harlan Ellison	A boy and his dog	1969
Connie Willis	All Clear (All Clear, #2)	Connie Willis, 
Svetlana Alexievich	Voices from Chernobyl: The Oral History of a Nuclear Disaster	Svetlana Alexievich, 
Naguib Mahfouz	Palace Walk / Palace of Desire / Sugar Street (The Cairo Trilogy #1-3)	Naguib Mahfouz, 
Stieg Larsson	The Girl with the Dragon Tattoo (Millennium, #1)	Stieg Larsson, 
John Milton	Paradise Lost	John Milton, 
Mark Twain	The Adventures of Huckleberry Finn	Mark Twain, 
Beam Piper	Paratime Police
James Morrow	the wine of violence
Peter Høeg	Smilla's Sense of Snow	Peter Høeg, 
Virginia Woolf	Mrs. Dalloway	Virginia Woolf, 
Max Nowaz	The Polymorph	Max Nowaz, 
Pangborn	David
Umberto Eco	Foucault’s Pendulum	Umberto Eco, 
Thomas Mann	Doctor Faustus	Thomas Mann, 
Alexei Panshin	Rite of Passage
Stephenie Meyer	Twilight (The Twilight Saga, #1)	Stephenie Meyer, 
Robert A. Heinlein	Double Star	Robert A. Heinlein, 
Gene Wolfe	death of dr. island
George R.R. Martin	A song for Lya
Harlan Coben	Tell No One	Harlan Coben, 
Hermann Hesse	Siddhartha	Hermann Hesse, 
Robert Silverberg	the stochastic man
Thomas Pynchon	Gravity’s Rainbow	Thomas Pynchon, 
Salman Rushddie	Midnight Children
Poul Pournelle, Larry Niven	World of Ptavvs
Kate Alice Marshall	What Lies in the Woods	Kate Alice Marshall, 
José Saramago	Seeing	José Saramago, 
Fyodor Dostoevsky	Crime and Punishment	Fyodor Dostoevsky, 
Gene Wolfe	Book of Sun
Robert L. Forward	Ocean Under the Ice (1994) 
Richard Cowper	The Twilight of Briareus
Jack Vance	Tschai
Elizabeth Gilbert	Eat, Pray, Love	Elizabeth Gilbert, 
Stephen King	It	Stephen King, 
Tom Rob Smith	Child 44 (Leo Demidov, #1)	Tom Rob Smith, 
Arkady Martine	A Desolation Called Peace (Teixcalaan, #2)	Arkady Martine, 
Greg Bear	The Wind from a Burning Women
Jonna Russ	The female man
J. G. Ballard	the atrocity exhibition
Lisa Jewell	None of This Is True	Lisa Jewell, 
Yann Martel	Life of Pi	Yann Martel, 
Ernest Hemingway	The Old Man and the Sea	Ernest Hemingway, 
John Crowley	Engine Summer
Joe Haldeman	The Forever War (The Forever War, #1)	Joe Haldeman, 
Alfred Bester	The Stars My Destination	Alfred Bester, 
Hubert Selby Jr.	Requiem for a Dream	Hubert Selby Jr., 
Homer	The Odyssey	Homer, 
Patricia Cornwell	Postmortem (Kay Scarpetta, #1)	Patricia Cornwell, 
Albert Camus	The Rebel	Albert Camus, 
Caleb Carr	The Alienist (Dr. Laszlo Kreizler, #1)	Caleb Carr, 
R.D. Ronald	The Elephant Tree	R.D. Ronald, 
Douglas Adams	The Hitchhiker’s Guide to the Galaxy (Hitchhiker's Guide to the Galaxy, #1)	Douglas Adams, 
Jean-Paul Sartre	Nausea	Jean-Paul Sartre, 
Ray Bradbury	One more for the road	Ray Bradbury, science fiction,	science-fiction
Gene Wolfe	the claw of the conciliator
Freida McFadden	Never Lie	Freida McFadden, 
Dan Brown	The Da Vinci Code (Robert Langdon, #2)	Dan Brown, 
Jack Kerouac	On the Road	Jack Kerouac, 
Joan D. Vinge	Eyes of Amber	
L. Ron Hubbard	The invaders plan
Michael Coney	Charisma
D.H. Lawrence	Lady Chatterley's Lover	D.H. Lawrence, 
Aleksandr Solzhenitsyn	One Day in the Life of Ivan Denisovich	Aleksandr Solzhenitsyn, 
Ken Kesey	One Flew Over the Cuckoo’s Nest	Ken Kesey, 
Ernest Hemingway	The Complete Short Stories of Ernest Hemingway	Ernest Hemingway, 
George Turner	Vaneglory
Jules Verne	Around the World in Eighty Days	Jules Verne, 
Kit Reed	the revenge of the senior citizens
Bruce Sterling	The artificial kid
David Brin	Heart of the comet
Robert A. Heinlein	Time enough for love
Douglas Adams	The Ultimate Hitchhiker’s Guide to the Galaxy (Hitchhiker's Guide to the Galaxy, #1-5)	Douglas Adams, 
Harry Harrison	Bill: the galactic here
Ian McEwan	Atonement	Ian McEwan, 
Ian R. MacLeod	The Visitor From Taured	Best Science Fiction of the Year (#2), 2017, Neil Clarke	science-fiction
Beam Piper	Fuzzy Sapiens
Cormac McCarthy	The Road	Cormac McCarthy, 
Sigrid Undset	Kristin Lavransdatter	Sigrid Undset, 
Octavia E. Butler	survivor
Thomas Mann	Death in Venice	Thomas Mann, 
Clifford D. Simak	all flesh is grass
Alice Sebold	The Lovely Bones	Alice Sebold, 
Luigi Pirandello	Six Characters in Search of an Author	Luigi Pirandello, 
Keith Laumer	Worlds of the Imperium
Hilbert Schenck	A rose for Armageddon
Martin L. Shoemaker	Today I Am Paul	Neil Clarke, The Best Science Fiction of the Year (Volume #1), Science Fiction, Short Story, Novelette	science-fiction
Sergio Cobo	A Story of Yesterday	Sergio Cobo, 
Gregg Andrew Hurwitz	The Nowhere Man (Orphan X, #2)	Gregg Andrew Hurwitz, 
Stanisław Lem, Peter Swirski	A Stanislaw Lem Reader	Stanisław Lem, science fiction,	science-fiction
Donald Kinsbury	The moon goddess and the son
Ed Bryant	Cinnabar
Somtow Sucharitkul	
Jack Vance	The Demon Princes
Michael Crichton	State of Fear	Michael Crichton, 
H.G. Wells	The war in the air	H.G. Wells, 
Boris Pasternak	Doctor Zhivago	Boris Pasternak, 
Ann Leckie	Ancillary Justice (Imperial Radch, #1)	Ann Leckie, 
Johnathon Nicolaou	Of Monsters and Planes	Johnathon Nicolaou, 
John Harrison	The machine in Shaft ten
Tom Clancy	Patriot Games (Jack Ryan, #1)	Tom Clancy, 
Ray Bradbury	Long After Midnight	Ray Bradbury, science fiction,	science-fiction
David Ellis	Look Closer	David Ellis, 
Vonda N. McIntyre	Dreamsnake	Vonda N. McIntyre, 
Rudyard Kipling	The Jungle Books	Rudyard Kipling, 
Giovanni Boccaccio	The Decameron	 Giovanni Boccaccio, Satire, Romance, Short Stories with a Frame Story	satire
Joe Haldeman	Mindbridge
Vladimir Nabokov	Lolita	Vladimir Nabokov, 
Arcady and Boris Strugatsky	far rainbow
William Gibson	Burning Chrome	William Gibson, 
James Ellroy	The Black Dahlia (L.A. Quartet, #1)	James Ellroy, 
T.S. Eliot	The Love Song of J. Alfred Prufrock and Other Poems	T.S. Eliot, 
Richard Cowper	Piper at the Gates of Dawn
John Brunner	The condition of Muzak
Charlie Donlea	The Girl Who Was Taken	Charlie Donlea, 
Kate Wilhelm	Where Late the Sweet Birds Sang	Kate Wilhelm, 
Robert Shekley	Options
Stephen King	The Shining (The Shining, #1)	Stephen King, 
Ayn Rand	Atlas Shrugged	Ayn Rand, 
Mark Clifton	They'd Rather Be Right	Mark Clifton, 
Emily Brontë	Wuthering Heights	Emily Brontë, 
José Saramago	All the Names	José Saramago, 
John Berendt	Midnight in the Garden of Good and Evil	John Berendt, 
Gregory Benford	In the ocean of night
Russel Hoban	Riddley walker
Frederik Pohl	cool war
Wilkie Collins	The Woman in White	Wilkie Collins, 
Lois McMaster Bujold	Paladin of Souls (World of the Five Gods, #2)	Lois McMaster Bujold, 
Beam Piper	Space Viking
A.E. van Vogt	Slan (Slan, #1)	A.E. van Vogt, 
Carl Sagan	Contact	Carl Sagan, 
John Harrison	Centauri Device
Paul Williams	Pelbar Cycle
Tana French	In the Woods (Dublin Murder Squad, #1)	Tana French, 
Heinrich Böll	Group Portrait with Lady	Heinrich Böll, 
Leo Tolstoy	War and Peace	Leo Tolstoy, 
Gene Wolfe	The shadow of the torturer
Ed Bryant	Men Inside
Tomas M. Disch	Casablanca
Charles Dickens	A Tale of Two Cities	Charles Dickens, 
Patrick Süskind	Perfume: The Story of a Murderer	Patrick Süskind, 
Philip José Farmer	To Your Scattered Bodies Go (Riverworld, #1)	Philip José Farmer, 
Ernest Hemingway	The Sun Also Rises	Ernest Hemingway, 
Paul Anderson	Brain Wave
Salman Rushdie	Midnight’s Children	Salman Rushdie, 
Ursula K. Le Guin	The Lathe of Heaven	Ursula K. Le Guin, 
Charles Dickens	David Copperfield	Charles Dickens, 
Robert A. Heinlein	I will fear no evil
Nathaniel Hawthorne	The Scarlet Letter	Nathaniel Hawthorne, 
Rudyard Kipling	Just So Stories	Rudyard Kipling, 
Svetlana Alexievich	Secondhand Time: The Last of the Soviets	Svetlana Alexievich, 
Kingsley Amis	Russian Hide-and-Seek
Truman Capote	In Cold Blood	Truman Capote, 
Mary Wollstonecraft Shelley	Frankenstein: The 1818 Text	Mary Wollstonecraft Shelley, 
Robert L. Forward	Marooned on Eden (1993)
Kate Alice Marshall	No One Can Know	Kate Alice Marshall, 
Richard K. Morgan	Altered Carbon (Takeshi Kovacs, #1)	Richard K. Morgan, 
Salman Rushdie	The Satanic Verses	Salman Rushdie, 
Tess Gerritsen	The Surgeon (Rizzoli & Isles, #1)	Tess Gerritsen, 
George Bernard Shaw	Saint Joan	George Bernard Shaw, 
Ernest Hemingway	A Moveable Feast	Ernest Hemingway, 
William S. Burroughs	Naked Lunch	William S. Burroughs, 
Larry Niven	The Mote in God's Eye (Moties, #1)	Larry Niven, 
Jostein Gaarder	Sophie’s World	Jostein Gaarder, 
Milan Kundera	The Unbearable Lightness of Being	Milan Kundera, 
Daphne du Maurier	Rebecca	Daphne du Maurier, 
J.R.R. Tolkien	The Silmarillion	J.R.R. Tolkien, 
Robert Charles Wilson	Spin (Spin, #1)	Robert Charles Wilson, 
George R.R. Martin	fevre dream
Ray Bradbury	Dark carnival	Ray Bradbury, science fiction,	science-fiction
Michael Moorcock	Byzantine Endures
George Orwell	Animal Farm	George Orwell, 
Heinrich Böll	The Clown	Heinrich Böll, 
David Brin	Sundiver
Ken Follett	Eye of the Needle	Ken Follett, 
Ray Bradbury	Farewell summer	Ray Bradbury, science fiction,	science-fiction
Alan Dean Foster	into the out of
Dozois	Strangers
David Foster Wallace	Infinite Jest	David Foster Wallace, 
J.M. Coetzee	Disgrace	J.M. Coetzee, 
Dave Eggers	A Heartbreaking Work of Staggering Genius	Dave Eggers, 
Joseph Heller	Catch-22	Joseph Heller, 	
Michael Moorcock	Behold the man
Dozois	Morning child
Michael Coney	Hello, Summer, Goodbye
Ruth Ware	The Woman in Cabin 10	Ruth Ware, 
Mark Haddon	The Curious Incident of the Dog in the Night-Time	Mark Haddon, 
Louisa May Alcott	Little Women	Louisa May Alcott, 
Ray Bradbury	Dandelion Wine	Ray Bradbury, science fiction,	science-fiction
Bob Shaw	Orbitsville Departure
Gregory Maguire	Wicked: The Life and Times of the Wicked Witch of the West (The Wicked Years, #1)	Gregory Maguire, 
Charlotte Brontë	Jane Eyre	Charlotte Brontë, 
Mary Doria Russell	The Sparrow (The Sparrow, #1)	Mary Doria Russell, 
Kurt Vonnegut Jr.	Cat’s Cradle	Kurt Vonnegut Jr., 
Karin Slaughter	Blindsighted (Grant County, #1)	Karin Slaughter, 
Robert Silverberg	Dying Inside
Ira Leven	The stepford wives
Noelle W. Ihli	Ask for Andrea	Noelle W. Ihli, 
James Patterson	1st to Die (Women's Murder Club, #1)	James Patterson, 
Fritz Leiber	Conjure Wife	Fritz Leiber, 
Ira Leven	This perfect day
Fritz Leiber	The Big Time	Fritz Leiber, 
Fritz Leiber	The Big Time	Fritz Leiber, 
Poul Pournelle	Janissaries
Iain M. Banks	The Player of Games (Culture, #2)	Iain M. Banks, 
Miguel Ángel Asturias	The President	Miguel Ángel Asturias, 
Ernest Hemingway	A Farewell to Arms	Ernest Hemingway, 
Josephine Saxton	Lovers from beyond the dawn of time
Kurt Vonnegut Jr.	The Sirens of Titan	Kurt Vonnegut Jr., 
Alfred Bester	The Demolished Man	Alfred Bester, 
Christopher Priest	The Space Machine
Harlan Coben	Think Twice (Myron Bolitar, #12)	Harlan Coben, 
Frederik Pohl	syzyjy
Robert A. Heinlein	Stranger in a Strange Land	Robert A. Heinlein, 
Robert M. Pirsig	Zen and the Art of Motorcycle Maintenance: An Inquiry Into Values (Phaedrus, #1)	Robert M. Pirsig, 
Leigh Brackett	Shadow Over Mars	Leigh Brackett, 
John Sladek	Miller-Fokker Effect
Johnathon Nicolaou	Dome: Rebellion (Dome, #1)	Johnathon Nicolaou, 
John Scalzi	Redshirts	John Scalzi, 
Pablo Neruda	Twenty Love Poems and a Song of Despair	Pablo Neruda, 
William Faulkner	As I Lay Dying	William Faulkner, 
Robert Shekley	Mindswap
Roger Zelazny	Lord of Light	Roger Zelazny, 
Pangborn	A mirror for observers
Agatha Christie	And Then There Were None	Detective Fiction, Mystery Fiction, Agatha Christie	mystery-detective
Kenzaburō Ōe	A Personal Matter	Kenzaburō Ōe, 
Misba	The High Auction (Wisdom Revolution, #1)	Misba, 
Stephen Hawking	A Brief History of Time	Stephen Hawking, 
Samuel R. Delany	Babel-17	1966
Doris Lessing	The Marraiges between zones three, four, five
Michael Connelly	The Black Ice (Harry Bosch, #2; Harry Bosch Universe, #2)	Michael Connelly, 
Knut Hamsun	Growth of the Soil	Knut Hamsun, 
Fritz Leiber	The Wanderer	Fritz Leiber, 
Roger Zelazny	Podkayne of mars	Roger Zelazny, 
Ray Bradbury	A sound of thunder	Ray Bradbury, science fiction,	science-fiction
Kurt Vonnegut Jr.	Slaughterhouse-Five	Kurt Vonnegut Jr., 
Robert J. Sawyer	Hominids (Neanderthal Parallax, #1)	Robert J. Sawyer, 
Anne Rice	Interview with the Vampire (The Vampire Chronicles, #1)	Anne Rice, 
Henry David Thoreau	Walden	Henry David Thoreau, 
Gillian Flynn	Gone Girl	Gillian Flynn, 
Dan Brown	The Lost Symbol (Robert Langdon, #3)	Dan Brown, 
Anna Cavan	Ice
Christopher Priest	Invered World
Dandy Smith	The Wrong Daughter	Dandy Smith, 
Kim Robinson	Icehenge
Dozois	Nightmare Blue
Charlie Donlea	Those Empty Eyes	Charlie Donlea, 
John Varley	The persistence of vision
William Paul Young	The Shack	William Paul Young, 
Joe Haldeman	Forever Peace (The Forever War, #3)	Joe Haldeman, 
Wilkie Collins	The Moonstone	Wilkie Collins, 
William Gibson	Count Zero	William Gibson, 
Tomas M. Disch	The puppies of terra
Kim Stanley Robinson	Red Mars (Mars Trilogy, #1)	Kim Stanley Robinson, 
J.D. Salinger	The Catcher in the Rye	J.D. Salinger, 
J.R.R. Tolkien	The Hobbit (The Lord of the Rings, #0)	J.R.R. Tolkien, 
Hilbert Schenck	Three Days at the end of the world
Martha Wells	Exit Protocol (The Murderbot Diaries, #4)	Martha Wells, science fiction,	science-fiction
Frank Herbert	Dune (Dune, #1)	Frank Herbert, 
Kingsley Amis	The alteration
John Wyndham	The Day of the Triffids	John Wyndham, 
Stieg Larsson	The Girl Who Kicked the Hornet’s Nest (Millennium, #3)	Stieg Larsson, 
Mary Wollstonecraft Shelley	Frankenstein	Mary Wollstonecraft Shelley, 
Mary Robinette Kowal	The Calculating Stars (Lady Astronaut Universe, #1)	Mary Robinette Kowal, 
David I. Masson	Traveller's Rest
Gene Wolfe	the citadel of the autarch
Doris Lessing	the sirian experiments
George Bernard Shaw	Pygmalion	George Bernard Shaw, 
Robert L. Forward	The flight of the drangonfly	Robert L. Forward, science fiction	science-fiction
Stephen Crane	The Red Badge of Courage	Stephen Crane, 
H.G. Wells	Kipps	H.G. Wells, 
Alastair Reynolds	Revelation Space (Revelation Space, #1)	Alastair Reynolds, 
Charles Darwin	The Origin of Species	Charles Darwin, 
Gillian Flynn	Sharp Objects	Gillian Flynn, 
Christopher Priest	Glamour
Sharon Baker	Quarreling, they met dragon
Frederik Pohl	Midas world
N.K. Jemisin	The Obelisk Gate (The Broken Earth, #2)	N.K. Jemisin, 
C.J. Cherryh	Downbelow Station (The Company Wars, #1)	C.J. Cherryh, 
Hermann Hesse	The Glass Bead Game	Hermann Hesse, 
Dozois	Hunter's run
George R.R. Martin	A Game of Thrones (A Song of Ice and Fire, #1)	George R.R. Martin, 
Orhan Pamuk	My Name Is Red	Orhan Pamuk, 
William Gibson	Idoru	William Gibson, 
Knut Hamsun	Pan	Knut Hamsun, 
Gillian Flynn	Dark Places	Gillian Flynn, 
Michael Moorcock	the laughter of carthage
William Gibson	Agency	William Gibson, 
H.G. Wells	The Island of Doctor Moreau	H.G. Wells, 1986
V.S. Naipaul	A House for Mr Biswas	V.S. Naipaul, 
N.K. Jemisin	The Fifth Season (The Broken Earth, #1)	N.K. Jemisin, 
Philip K. Dick	A Scanner Darkly	Philip K. Dick, 
Harry Harrison	a transatlantic tunnel, hurrah!
John Steinbeck	Cannery Row (Cannery Row, #1)	John Steinbeck, 
Chuck Palahniuk	Fight Club	Chuck Palahniuk, 
Ray Bradbury	Something wicked this way comes	Ray Bradbury, science fiction,	science-fiction
Selma Lagerlöf	Gösta Berling's Saga	Selma Lagerlöf, 
Homer	The Iliad	Homer, 
Vonda N. McIntyre	The exile waiting 
Frederik Pohl	Jem
Mikhail Bulgakov	The Master and Margarita	Mikhail Bulgakov, 
Tim Powers	Dinner at deviant's palace
George Turner	Beloved Son
Clifford D. Simak	Way Station	Clifford D. Simak, 
C.J. Cherryh	Cyteen (Cyteen, #1-3)	C.J. Cherryh, 
Kit Reed	Armed Camps
Diane Setterfield	The Thirteenth Tale	Diane Setterfield, 
Michael Bishop	Transfiguration
Arcady and Boris Strugatsky	the snal on the slope
Brian Stableford	The third Millennium
Jorge Luis Borges	funes, the memorious
Damien Broderick	transmitters
Ian Waston	The Embassy
Michael Connelly	The Poet (Jack McEvoy, #1; Harry Bosch Universe, #5)	Michael Connelly, 
Robert L. Forward	Rescued from Paradise (1995) 
Imre Kertész	Fatelessness	Imre Kertész, 
Stephen King	The Stand	Stephen King, 
F. Scott Fitzgerald	The Great Gatsby	F. Scott Fitzgerald, 
Samuel R. Delany	Nova	1898
William Gibson	Zero History	William Gibson, 
Ray Bradbury	yestermorrow	Ray Bradbury, science fiction,	science-fiction
Greg Bear	Blood Music
Bob Shaw	Orbitsville
Samuel Beckett	Waiting for Godot	Samuel Beckett, 
John Crowley	The deep
Agatha Christie	The Mysterious Affair at Styles (Hercule Poirot, #1)	Agatha Christie, 
Alan Dean Foster	star wars
Jorge Luis Borges	in the library of babel
Robert L. Forward	Return to Rocheworld (1993)
Neal Stephenson	The Diamond Age: Or, a Young Lady's Illustrated Primer	Neal Stephenson, 
Tom Clancy	The Sum of All Fears (Jack Ryan, #6)	Tom Clancy, 
Jules Verne	In Search of the Castaways
Jules Verne	In Search of the Castaways
Toni Morrison	Song of Solomon	Toni Morrison, 
Rudy Rucker	White light
Damien Broderick	The dreaming dragons
Philip K. Dick	The Transmigration of Timothy Archer	Philip K. Dick, 
Bruce Sterling	Involution Ocean	Bruce Sterling
Rudy Rucker	Spacetime Donuts	
H.G. Wells	Tono-bungay	H.G. Wells, 
J.D. Robb	Naked in Death (In Death, #1)	J.D. Robb, 
Philip K. Dick	The Man in the High Castle	Philip K. Dick, 
Ray Bradbury	The halloween tree	Ray Bradbury, science fiction,	science-fiction
V.S. Naipaul	A Bend in the River	V.S. Naipaul, 
Hilbert Schenck	at the eyes of the ocean
William Gibson	The Bridge Trilogy	William Gibson, 
D. M. Thomas	The white hotel
Dan Brown	Deception Point	Dan Brown, 
George R.R. Martin	dying of the light
Kim Stanley Robinson	Green Mars (Mars Trilogy, #2)	Kim Stanley Robinson, 
A.J. Finn	The Woman in the Window	A.J. Finn, 
Ray Bradbury	Summer Morning, Summer Night	Ray Bradbury, science fiction,	science-fiction
Douglas Preston	Relic (Pendergast, #1)	Douglas Preston, 
Mario Vargas Llosa	The Feast of the Goat	Mario Vargas Llosa, 
Pearl S. Buck	The Good Earth (House of Earth, #1)	Pearl S. Buck, 
Kim Robinson	The memory of whiteness
Richard Cowper	Profundis
John Steinbeck	East of Eden	John Steinbeck, 
John Marrs	Keep It in the Family	John Marrs, 
Bob Shaw	Night Walk
Jean-Paul Sartre	No Exit	Jean-Paul Sartre, 
Mikhail Sholokhov	And Quiet Flows the Don	Mikhail Sholokhov, 
Philip José Farmer	Riders of the Purple Wage
Thomas Harris	The Silence of the Lambs (Hannibal Lecter, #2)	Thomas Harris, 
Paul Williams	The fall of the shell
Ray Bradbury	R is for rocket	Ray Bradbury, science fiction,	science-fiction
Frederik Pohl	Gateway
Ira Leven	the boys from brazil
Pangborn	The company of glory
Robert Louis Stevenson	Dr. Jekyll and Mr. Hyde	Robert Louis Stevenson, 
Ursula K. Le Guin	The Left Hand of Darkness	Ursula K. Le Guin, 
Ursula K. Le Guin	Always coming home
Lucius Shepherd	Salvado
Max Brooks	World War Z: An Oral History of the Zombie War	Max Brooks, 
Caroline Kepnes	You (You, #1)	Caroline Kepnes, 
Joseph Conrad	Heart of Darkness	Joseph Conrad, 
Neil Gaiman	The Graveyard Book	Neil Gaiman, 
Miguel de Cervantes Saavedra	Don Quixote	Miguel de Cervantes Saavedra, 
Dennis Lehane	Shutter Island	Dennis Lehane, 
Ed Bryant	Strata
David Archer	The Last Run (Peter Black #6)	David Archer, 
Alan Bradley	The Sweetness at the Bottom of the Pie (Flavia de Luce, #1)	Alan Bradley, 
Isaac Asimov	I, Robot (Robot, #0.1)	Isaac Asimov, 
John Steinbeck	The Grapes of Wrath	John Steinbeck, 
Gabriel Garcia Marquez	One Hundred Years Of Solitude	Magical Realism, Nobel Prize	magical-realism
Stephen King	The dead zone	Stephen King, 
Harlan Ellison	I have no mouth and I must scream	
Jack Vance	Durdane
Rudy Rucker	Software
Tomas M. Disch	The genocides
Saul Bellow	Herzog	Saul Bellow, 
David Guterson	Snow Falling on Cedars	David Guterson, 
Stanisław Lem, Peter Butko	Dialogues	Stanisław Lem, science fiction,	science-fiction
J. G. Ballard	The crystal world
Edgar Allan Poe	The Complete Stories and Poems	Edgar Allan Poe, 
Jane Austen	Pride and Prejudice	Jane Austen, 
Ray Bradbury	The October Country	Ray Bradbury, science fiction,	science-fiction
Michael Bishop	A funeral for the eyes of fire
Jeffrey Eugenides	Middlesex	Jeffrey Eugenides, 
Audrey Niffenegger	The Time Traveler's Wife	Audrey Niffenegger, 
Alan Dean Foster	The black hole
Octavia E. Butler	kindred
Gabriel García Márquez	Chronicle of a Death Foretold	Gabriel García Márquez, 
Harry Harrison	A stainless steel rat is born
Alan Dean Foster	Dark Star
Dennis Lehane	Mystic River	Dennis Lehane, 
Neil Gaiman	American Gods	Neil Gaiman, 
Tomas M. Disch	Angouleme
Philip K. Dick	Flow My Tears, The Policeman Said	Philip K. Dick, 
Doris Lessing	canopus in argos: archives
Arthur C. Clarke	A meeting with Medusa
Ernest Cline	Ready Player One (Ready Player One, #1)	Ernest Cline, 
Kurt Vonnegut Jr.	Mother Night
Doris Lessing	Memoirs of a survivor
Michael Connelly	The Concrete Blonde (Harry Bosch, #3; Harry Bosch Universe, #3)	Michael Connelly, 
James Patterson	Jack & Jill (Alex Cross, #3)	James Patterson, 
Tomas M. Disch	Camp Concentration
H.G. Wells	The Invisible Man	H.G. Wells, 1897
Elizabeth Kostova	The Historian	Elizabeth Kostova, 
Jules Verne	From the Earth to the Moon
Jules Verne	From the Earth to the Moon
Tim Powers	The annubis gates
Agatha Christie	Murder on the Orient Express (Hercule Poirot, #10)	Agatha Christie, 
Frederik Pohl	The years of the city
Herman Melville	Moby-Dick or, The Whale	Herman Melville, 
Josef Nesvadba	expeditin in the opposite direction
Knut Hamsun	Mysteries	Knut Hamsun, 
Terry Hayes	I Am Pilgrim	Terry Hayes, 
Elfriede Jelinek	The Piano Teacher	Elfriede Jelinek, 
James Blish	A Case of Conscience (After Such Knowledge, #4)	James Blish, 
James Patterson	Along Came a Spider (Alex Cross, #1)	James Patterson, 
Robin Cook	Coma	Robin Cook, 
Elizabeth Peters	Crocodile on the Sandbank (Amelia Peabody #1)	Elizabeth Peters, 
Robert Silverberg	Nightwings
Paula Hawkins	The Girl on the Train	Paula Hawkins, 
Arcady and Boris Strugatsky	hard to be a god
Robert Shekley	The Alchemical Marriage of Alstair Crompton / Crompton Divided
Kim Stanley Robinson	Blue Mars (Mars Trilogy, #3)	Kim Stanley Robinson, 
James M. Cain	The Postman Always Rings Twice	James M. Cain, 
William Golding	Lord of the Flies	William Golding, 
Michal Kube-MacDowell	Enigma
Saul Bellow	Seize the Day	Saul Bellow, 
Lois McMaster Bujold	Mirror Dance (Vorkosigan Saga, #8)	Lois McMaster Bujold, 
R.D. Ronald	The Zombie Room	R.D. Ronald, 
Tomas M. Disch	The Asian Shore
Tom Clancy	Executive Orders (Jack Ryan, #8)	Tom Clancy, 
J. G. Ballard	The drowned world
Neal Stephenson	Anathem	Neal Stephenson, 
Connie Willis	Doomsday Book (Oxford Time Travel, #1)	Connie Willis, 
Alexandre Dumas	The Count of Monte Cristo	Alexandre Dumas, 
David I. Masson	Mouth of Hell 
George R.R. Martin	windhaven
George Turner	Yesterday's Man
Frank Herbert	Children of Dune
Toni Morrison	Beloved	Toni Morrison, 
Douglas Preston	The Cabinet of Curiosities (Pendergast, #3; Nora Kelly, #0B)	Douglas Preston, 
Alan Dean Foster	outland
Philip K. Dick	The eye in the sky	Philip K. Dick, 
P.D. James	An Unsuitable Job for a Woman (Cordelia Gray, #1)	P.D. James, 
Anthony Burgess	A Clockwork Orange	Anthony Burgess, 
Robin Waterfield (Adaptor)	The Firm	Robin Waterfield (Adaptor), 
Connie Willis	To Say Nothing of the Dog (Oxford Time Travel, #2)	Connie Willis, 
James Morrow	this is the way the world ends
Bram Stoker	Dracula	Bram Stoker, 
Keith Roberts	anita
Beam Piper	Uller Uprising
James Joyce	Ulysses	James Joyce, 
David D. Bunch	Moderan
Knut Hamsun	Hunger	Knut Hamsun, 
Susanna Clarke	Jonathan Strange & Mr Norrell	Susanna Clarke, 
John Crowley	Beasts
Carlos Ruiz Zafón	The Shadow of the Wind (The Cemetery of Forgotten Books, #1)	Carlos Ruiz Zafón, 
J.M. Coetzee	Waiting for the Barbarians	J.M. Coetzee, 
Rudyard Kipling	Kim	Rudyard Kipling, 
Karin Smirnoff	The Girl in the Eagle's Talons (Millennium, #7)	Karin Smirnoff, 
Harry Harrison	make room! make room!
Umberto Eco	The Name of the Rose	Umberto Eco, 
George Zebrowsky	Macrolife
Ray Bradbury	The Illustrated Man	Ray Bradbury, science fiction,	science-fiction
Robert L. Forward	Robert L. Forward	Starquake (1985)
Johnathon Nicolaou	The Chain Between Worlds (The Lost Artefacts #1)	Johnathon Nicolaou, 
Noelle W. Ihli	Gray After Dark	Noelle W. Ihli, 
Russel Griffin	the blind man and the elephant
Thomas Mann	The Magic Mountain	Thomas Mann, 
Rabindranath Tagore	Gitanjali	Rabindranath Tagore, 
Sinclair Lewis	Main Street	Sinclair Lewis, 
Gordon R. Dickson	Dorsai Series
Geoffrey Chaucer	The Canterbury Tales	Geoffrey Chaucer, 
Robert L. Forward	Rocheworld (Baen, 1990)
David Brin	Startide Rising (The Uplift Saga, #2)	David Brin, 
Richard Matheson	I Am Legend	Richard Matheson, 
Isaac Asimov	last and first men
Douglas Preston	Reliquary (Pendergast, #2)	Douglas Preston, 
Douglas R. Hofstadter	Gödel, Escher, Bach: An Eternal Golden Braid	Douglas R. Hofstadter, 
Robert Ludlum	The Bourne Supremacy (Jason Bourne, #2)	Robert Ludlum, 
Stephen King	Different Seasons	Stephen King, 
Henryk Sienkiewicz	Quo Vadis	Henryk Sienkiewicz, 
Michael Bishop	No enemy but time
Aleksandr Solzhenitsyn	The Gulag Archipelago 1918–1956	Aleksandr Solzhenitsyn, 
Frederick Forsyth	The Day of the Jackal	Frederick Forsyth, 
Eugene O'Neill	Long Day’s Journey into Night	Eugene O'Neill, 
Arthur C. Clarke	A fall of moondust
Isaac Asimov	The robot of dawn
T. Kingfisher	Nettle & Bone	T. Kingfisher, 
Dashiell Hammett	The Thin Man	Dashiell Hammett, 
Samuel R. Delany	Dhalgren	1975
Dozois	The peacemaker
Debra Webb	Deeper Than the Dead (Vera Boyett, #1)	Debra Webb, 
Kate Atkinson	Case Histories (Jackson Brodie, #1)	Kate Atkinson, 
Raymond Chandler	The Big Sleep (Philip Marlowe, #1)	Raymond Chandler, 
Kit Reed	The killer Mice
James Joyce	Finnegans Wake	James Joyce, 
Margaret Mitchell	Gone with the Wind	Margaret Mitchell, 
Rudyard Kipling	The Jungle Book (Jungle Book, #1)	Rudyard Kipling, 
Ray Bradbury	A graveyard for lunatics	Ray Bradbury, science fiction,	science-fiction
Tom Clancy	The Hunt for Red October (Jack Ryan, #3)	Tom Clancy, 
Melinda Leigh	On Her Watch (Bree Taggert, #8)	Melinda Leigh, 
Ray Bradbury	Another fine mess	Ray Bradbury, science fiction,	science-fiction
J.R.R. Tolkien	The Lord of the Rings (Middle Earth, #2-4)	J.R.R. Tolkien, 
Barry Malzberg	Herowit's World
Bret Easton Ellis	American Psycho	Bret Easton Ellis, 
Frederik Pohl	the merchant's war
Octavia E. Butler	clay's ark
Timemaster (1992)
Greg Bear	Eon
Kazuo Ishiguro	Never Let Me Go	Kazuo Ishiguro, 
Ivo Andrić	The Bridge on the Drina (Bosnian Trilogy, #1)	Ivo Andrić, 
Octavia E. Butler	Mind of my mind
Michael Crichton	Sphere	Michael Crichton, 
John Grisham	The Pelican Brief	John Grisham, 
Norman Spinrad	Big Jack Barron
Ian Waston	the gardens of delight
John Calvin Batchelor	The birth of the people's antarctica
Leo Tolstoy	Anna Karenina	Leo Tolstoy, 
Suzette Haden Elgin	Mother Tongue
Robert A. Heinlein	Farmer in the Sky	Robert A. Heinlein, 
Roger Zelazny	A rose for ecclesiastes	Roger Zelazny, 
Halldór Laxness	Independent People	Halldór Laxness, 
T.H. White	The Sword in the Stone (The Once and Future King, #1)	T.H. White, 
John Grisham	The Client	John Grisham, 
John Steinbeck	The Pearl	John Steinbeck, 
Richard Cowper	Road to Corlay
Albert Camus	The Plague	Albert Camus, 
Jeffery Deaver	The Coffin Dancer (Lincoln Rhyme, #2)	Jeffery Deaver, 
Robert L. Forward	Camelot 30K (1993)
J. G. Ballard	the terminable beach
Arthur C. Clarke	Rendezvous with Rama (Rama, #1)	Arthur C. Clarke, 
Salman Rushddie	Grimus
William Gibson	Spook Country	William Gibson, 
Patrick White	A fringe of leaves
Larry Niven	Ringworld (Ringworld, #1)	Larry Niven, 
Christopher Priest	The Dream of Wessex
Ernest Hemingway	For Whom the Bell Tolls	Ernest Hemingway, 
Douglas Adams	The Hitchhiker’s Guide to the Galaxy (The Hitchhiker's Guide to the Galaxy, #1)	Douglas Adams, 
Patricia Highsmith	The Talented Mr. Ripley (Ripley, #1)	Patricia Highsmith, 
Philip K. Dick	Ubik	Philip K. Dick, 
John Brunner	The sheep loop up
John Harrison	running down
William Gibson	The Jackpot Trilogy	William Gibson, 
Iain M. Banks	Use of Weapons (Culture, #3)	Iain M. Banks, 
Arthur Conan Doyle	A Study in Scarlet and The Sign of Four	Arthur Conan Doyle, 
Riley Sager	The Only One Left	Riley Sager, 
Josef Nesvadba	In the footsteps of the abominable snowman / the lost face
Ellery Lloyd	The Club	Ellery Lloyd, 
Gene Wolfe	the sword of the lictor
Alan Dean Foster	midworld
David Brin	The Postman
Janet Evanovich	One for the Money (Stephanie Plum, #1)	Janet Evanovich, 
John Galsworthy	The Forsyte Saga (The Forsyte Chronicles, #1-3)	John Galsworthy, 
Alasdair Gray 	Janine	
Ray Bradbury	The day it rained forever	Ray Bradbury, science fiction,	science-fiction
Hugh Howey	Wool Omnibus (Silo, #1)	Hugh Howey, 
Wolfgan Jeshke	the last days of creation
Ed Bryant	Beyond Apollo
Ian Waston	The martian Inca
Samuel R. Delany	Driftglass	1971
Clifford D. Simak	ring around the sun
José Saramago	Blindness	José Saramago, 
John Varley	Ophiuchi Hotline
J.R.R. Tolkien	The Fellowship of the Ring (The Lord of the Rings, #1)	J.R.R. Tolkien, 
Arthur Conan Doyle	A Study in Scarlet (Sherlock Holmes, #1)	Arthur Conan Doyle, 
José Saramago	Death with Interruptions	José Saramago, 
Peter Benchley	Jaws (Jaws, #1)	Peter Benchley, 
William Gibson	Pattern Recognition	William Gibson, 
Peter F. Hamilton	Pandora's Star (Commonwealth Saga, #1)	Peter F. Hamilton, 
Edgar Rice Burroughs	A Princess of Mars (Barsoom, #1)	Edgar Rice Burroughs, 
Lois McMaster Bujold	Barrayar (Vorkosigan Saga, #7)	Lois McMaster Bujold, 
Josephine Saxton	Group Feast
charles Grant	the ravens of the moon
Poul Pournelle, Larry Niven	Inferno
Neil Gaiman	American Gods (American Gods, #1)	Neil Gaiman, 
Clifford D. Simak	The city
Ken Follett	The Pillars of the Earth (Kingsbridge, #1)	Ken Follett, 
James M. Cain	Double Indemnity	James M. Cain, 
Paul Williams	The Breaking of the Northwall
Günter Grass	The Tin Drum	Günter Grass, 
Stephen King	Carrie	Stephen King, 
Stephen King	Carrie	Stephen King, 
James Patterson	Kiss the Girls (Alex Cross, #2)	James Patterson, 
Hermann Hesse	Narcissus and Goldmund	Hermann Hesse, 
Anonymous	The Holy Bible: King James Version	Anonymous, 
Jonathan Swift	Gulliver’s Travels	Jonathan Swift, 
John Steinbeck	Of Mice and Men	John Steinbeck, 
J. G. Ballard	crash!
Jorge Luis Borges	tlon, uqbar, orbis tertius
William Faulkner	The Sound and the Fury	William Faulkner, 
Jeffery Deaver	The Bone Collector (Lincoln Rhyme, #1)	Jeffery Deaver, 
Dante Alighieri	The Divine Comedy	Dante Alighieri, 
Michael Connelly	The Lincoln Lawyer (The Lincoln Lawyer, #1; Harry Bosch Universe, #16)	Michael Connelly, 
Heinrich Böll	The Lost Honor of Katharina Blum	Heinrich Böll, 
Jason Rekulak	Hidden Pictures	Jason Rekulak, 
Jane Austen	Sense and Sensibility	Jane Austen, 
Ayn Rand	The Fountainhead	Ayn Rand, 
